MMMMMMMMMMMM
MMMMMMMMMMMM
MMMMMMMMMMMM
MMMMMMMMMMMM
TTTTTTTTTTTT
TTTTTTTTTTTT
TTTTTTTTTTTT
GGGGGGGGGGGG
GGGGGGGGGGGG
SSSSSSSSSSSS
SSSSSSSSSSSS
SSSSSSSSSSSS