TTTTTTTTTTTTTT
TTTTTTTTTTTTMM
TTTTTTTTTTTTMM
MMMMMMMMMMMMSS
MMMMMMMMMMMMSS
MMMMMMMMMMMMSS
MMMMMMMMMMMMSS
GGGGGGGGGGGGSS
GGGGGGGGGGGGSS
SSSSSSSSSSSSSS
SSSSSSSSSSSSGG
SSSSSSSSSSSSGG