TTTTTTTTTTTT
TTTTTTTTTTTT
TTTTTTTTTTTT
MMMMMMMMMMMM
MMMMMMMMMMMM
MMMMMMMMMMMM
MMMMMMMMMMMM
GGGGGGGGGGGG
GGGGGGGGGGGG
SSSSSSSSSSSS
SSSSSSSSSSSS
SSSSSSSSSSSS